8 6
4 0
4 5
########
#......#
#.#.##.#
#.#...##
#.##.#.#
#S#...F#
########